XXXXXXX
X@    X
X  bb X
XXXX  X
XXXX  X
XX..  X
XXXXXXX