XXXXXXXXXXXX
X@     XXXXX
X  b   XXXXX
X X XX XXXXX
X X XX X   X
X b b     .X
XXXXXXXX ..X
XXXXXXXXXXXX